# Example Map
S1 S1 S1 S1 S1 S1 S1 S1 S1 S1
S1 S2 S1 S0 S0 S0 S0 S0 S0 S1
S1 S0 S1 S0 S1 S3 S1 S1 S0 S1
S1 S0 S1 S0 S1 S0 S0 S4 S0 S1
S1 S0 S1 S0 S1 S0 S0 S1 S0 S1
S1 S0 S1 S0 S1 S1 S1 S1 S0 S1
S1 S0 S0 S0 S0 S0 S0 S0 S0 S1
S1 S0 S0 S0 S0 S0 S0 O0 S0 S1
S1 S0 S0 S0 S0 S0 S0 S0 S0 S1
S1 S1 S1 S1 S1 S1 S1 S1 S1 S1
